A 01110100011000110001111111000110001
a 00000000000111000001011111000101111
B 11110100011000111110100011000111110
b 10000100001000011110100011000111110
C 01110100011000010000100001000101110
c 00000000000111010001100001000101110
D 11110100011000110001100011000111110
d 00001000010000101111100011000101111
E 11111100001000011110100001000011111
e 00000000000111010001111111000001111
F 11111100001000011110100001000010000
f 00110010010100011100010000100001000
G 01110100011000010111101011000101110
g 00000000000111010001011110000101110
H 10001100011000111111100011000110001
h 10000100001000011110100011000110001
I 00100001000010000100001000010000100
i 00100000000110000100001000010001110
J 00010000100001000010000101001001100
j 00010000000011000010000101001001100
K 10001100011001011100100101000110001
k 10000100001000110010111001001010001
L 10000100001000010000100001000011111
l 01100001000010000100001000010001110
M 10001110111010110101100011000110001
m 00000000001111010101101011010110101
N 10001100011100110101100111000110001
n 00000000001111010001100011000110001
O 01110100011000110001100011000101110
o 00000000000111010001100011000101110
P 11110100011000111110100001000010000
p 00000000000111001001011100100001000
Q 01110100011000110001101011001101111
q 00000000000011101001001110000100001
R 11110100011000111110100011000110001
r 00000000001011111000100001000010000
S 01111100001000001110000010000111110
s 00000000000111110000011100000111110
T 11111001000010000100001000010000100
t 00100001000111000100001000010000011
U 10001100011000110001100011000101110
u 00000000001000110001100011001101101
V 10001100011000110001100010101000100
v 00000000001000110001100010101000100
W 10001100011000110101101011101110001
w 00000000001000110001101011111110101
X 10001100010101000100010101000110001
x 00000000001000101010001000101010001
Y 10001100010101000100001000010000100
y 00000000001000110001011110000111110
Z 11111000010001000100010001000011111
z 00000000001111100010001000100011111
