A 01110100011000110001111111000110001
B 11110100011000111110100011000111110
C 01110100011000010000100001000101110
D 11110100011000110001100011000111110
E 11111100001000011110100001000011111
F 11111100001000011110100001000010000
G 01110100011000010111101011000101110
H 10001100011000111111100011000110001
I 00100001000010000100001000010000100
J 00010000100001000010000101001001100
L 10000100001000010000100001000011111
K 10001100011001011100100101000110001
M 10001110111010110101100011000110001
N 10001100011100110101100111000110001
O 01110100011000110001100011000101110
P 11110100011000111110100001000010000
Q 01110100011000110001101011001101111
R 11110100011000111110100011000110001
S 01111100001000001110000010000111110
T 11111001000010000100001000010000100
U 10001100011000110001100011000101110
V 10001100011000110001100010101000100
W 10001100011000110101101011101110001
X 10001100010101000100010101000110001
Y 10001100010101000100001000010000100
Z 11111000010001000100010001000011111
a 00000000000111000001011111000101111
b 10000100001000011110100011000111110
c 00000000000111010001100001000101110
d 00001000010000101111100011000101111
e 00000000000111010001111111000001111
f 00110010010100011100010000100001000
g 00000000000111010001011110000101110
h 10000100001000011110100011000110001
i 00100000000110000100001000010001110
j 00010000000011000010000101001001100
k 10000100001000110010111001001010001
l 01100001000010000100001000010001110
m 00000000001111010101101011010110101
n 00000000001111010001100011000110001
o 00000000000111010001100011000101110
p 00000000000111001001011100100001000
q 00000000000011101001001110000100001
r 00000000001011111000100001000010000
s 00000000000111110000011100000111110
t 00100001000111000100001000010000011
u 00000000001000110001100011001101101
v 00000000001000110001100010101000100
w 00000000001000110001101011111110101
x 00000000001000101010001000101010001
y 00000000001000110001011110000111110
z 00000000001111100010001000100011111
0 01110100011001110101110011000101110
1 00100011001010000100001000010011111
2 01110100010000100110010001000011111
3 01110100010000100110000011000101110
4 00010001100101010010111110001000010
5 11111100001111000001000011000101110
6 01110100011000011110100011000101110
7 11111000010001000100001000010000100
8 01110100011000101110100011000101110
9 01110100011000101111000011000101110
